##############################################################
#...........................GGG..............................#
#............................................................#
#................................................G...........#
#............................................................#
#...............G............................................#
#............................................................#
#............................................................#
#.................................................G..........#
#........................#########...........................#
#........................#.......#...........................#
#........................#...@...#...........................#
#........................#.......#...........................#
#........................####.####...........................#
#....G.......................................................#
#............................................................#
#...................................................G........#
#............................................................#
#............................................................#
#............................................................#
#............................................................#
#............................................................#
#............................................................#
#....................G.......................................#
#............................................................#
##############################################################