##############################################################
#............................................................#
#............................................................#
#............................................................#
#............................................................#
#............................................................#
#............................................................#
#............................................................#
#............................................................#
#........................#########...........................#
#........................#.......#...........................#
#........................#...@...#...........................#
#........................#.......#...........................#
#........................####.####...........................#
#............................................................#
#............................................................#
#............................................................#
#............................................................#
#............................................................#
#............................................................#
#............................................................#
#............................................................#
#............................................................#
#............................................................#
#............................................................#
##############################################################